{"name":"The beginning of the beginning","tiles":
[
[0,0,0,0,0,0,0,0,0,0,0,0,0,0,0,0,0,0,0,0],
[0,0,0,0,0,0,0,0,0,0,0,0,0,0,0,0,0,0,0,0],
[0,0,0,0,0,0,0,0,0,0,0,0,0,0,0,0,0,0,0,0],
[0,0,0,0,0,0,0,0,0,0,0,0,0,0,0,0,2,2,0,0],
[0,0,0,0,0,0,0,0,0,0,0,0,0,0,0,0,0,0,0,0],
[0,0,0,0,0,0,0,0,0,0,0,0,0,0,2,2,0,0,0,0],
[0,0,0,0,0,0,0,0,3,0,0,0,0,0,0,0,0,0,0,0],
[0,0,0,0,0,0,0,0,0,0,0,0,2,2,0,0,0,0,0,0],
[0,0,0,0,0,0,2,0,0,0,0,0,0,0,0,0,0,0,0,0],
[0,0,0,0,0,0,2,2,2,2,0,0,0,0,0,0,0,0,0,0],
[0,0,0,0,0,0,0,0,0,1,2,2,0,0,0,0,0,0,0,0],
[0,0,0,0,0,0,0,0,0,0,0,0,0,0,0,0,0,0,0,0],
[0,0,0,0,0,0,0,0,0,0,0,0,0,0,0,0,0,0,2,0],
[0,0,0,0,0,0,0,0,0,0,0,0,2,2,2,0,0,0,0,0],
[0,0,0,0,0,0,0,0,0,0,0,0,0,0,0,0,0,2,2,0],
[0,0,0,0,0,0,0,2,2,2,2,0,0,0,0,0,0,0,0,0],
[0,0,0,0,0,0,0,0,0,0,0,0,0,0,0,0,2,2,2,0],
[0,0,0,0,0,0,0,0,0,0,0,0,0,0,0,0,0,0,0,0],
[0,0,0,0,0,0,0,0,0,0,0,0,0,0,0,2,2,2,2,0],
[0,0,0,0,2,0,0,0,0,0,0,0,0,0,0,0,0,0,0,0],
[0,0,0,0,1,2,2,2,0,0,0,2,2,2,2,2,2,2,0,0],
[0,0,0,0,0,0,0,0,0,0,0,0,0,0,0,0,0,0,0,0],
[0,0,0,0,2,2,2,2,2,0,0,0,0,0,0,0,0,0,0,0],
[0,0,0,0,0,0,0,0,0,0,0,0,0,0,0,0,0,0,0,0],
[0,0,0,0,0,0,0,0,0,2,2,2,2,2,2,0,0,0,0,0],
[0,0,0,0,0,0,0,0,0,0,0,0,0,0,0,0,0,0,0,0],
[0,0,0,0,0,0,0,0,0,0,0,0,0,0,0,0,0,0,0,0],
[0,0,0,0,0,0,0,0,0,0,0,0,0,0,0,2,2,2,0,0],
[0,0,0,0,0,0,0,0,0,0,0,0,0,0,0,0,0,0,0,0],
[0,0,0,0,0,0,0,0,0,0,0,0,0,0,0,0,0,0,0,3],
[0,0,0,0,0,0,0,0,0,0,0,0,0,0,0,0,0,0,0,0],
[0,0,0,0,0,0,0,0,0,0,0,0,0,0,0,0,0,3,0,0],
[0,0,0,0,0,0,0,3,0,0,0,0,0,0,0,0,0,0,0,0],
[0,0,0,0,0,0,3,0,0,2,2,2,0,0,0,2,2,2,0,0],
[0,0,0,0,0,3,0,0,0,0,0,0,0,0,0,0,0,0,0,0],
[0,0,0,0,3,0,0,0,0,0,0,0,0,0,0,0,0,0,0,0],
[0,0,0,0,0,0,0,0,0,0,0,0,0,0,0,0,0,0,0,0],
[0,0,2,2,0,0,0,0,0,0,0,0,0,0,0,0,0,0,0,0],
[0,0,0,0,2,2,0,0,0,0,0,0,0,0,0,0,0,0,0,0],
[0,0,0,0,0,0,2,2,0,0,0,0,0,0,0,0,0,0,0,0],
[0,0,0,0,0,0,0,0,2,2,0,0,0,0,0,0,0,0,0,0],
[0,0,0,0,0,0,0,0,0,0,0,0,0,0,0,0,0,0,0,0],
[0,0,0,0,0,0,0,0,0,0,0,0,0,0,0,0,0,0,0,0],
[0,0,0,0,0,0,0,0,2,2,2,2,2,2,2,2,2,0,0,0],
[0,0,0,0,0,0,2,2,0,0,0,0,0,0,0,0,0,0,0,0],
[0,0,0,0,0,0,0,0,0,0,0,0,0,0,0,0,0,0,0,0],
[0,0,0,0,2,2,2,2,2,2,2,2,2,0,0,0,0,0,0,0],
[0,0,0,0,0,0,0,0,0,0,0,0,0,0,0,0,0,0,0,0],
[0,0,0,0,0,0,0,0,0,0,0,0,0,0,0,0,0,0,0,0],
[0,0,2,2,2,2,0,0,0,0,0,0,0,0,0,0,0,0,0,0],
[0,0,0,0,0,0,2,2,2,0,0,0,0,0,0,0,0,0,0,0],
[0,0,0,0,0,0,0,0,0,2,2,2,2,0,0,0,0,0,0,0],
[0,0,0,0,0,0,0,0,0,0,0,0,0,2,2,0,0,0,0,0],
[0,0,0,0,0,0,0,0,0,0,0,0,0,0,0,2,2,0,0,0],
[0,0,0,0,0,0,0,0,0,0,0,0,0,0,0,0,0,0,0,0],
[0,0,0,0,0,0,0,0,0,0,0,0,0,0,0,0,0,0,2,2],
[0,0,0,0,0,0,0,0,0,0,0,0,0,0,0,0,2,2,1,1],
[0,0,0,0,0,0,0,0,0,0,0,0,0,0,2,2,1,1,1,1],
[0,0,0,0,0,0,0,0,0,0,0,2,2,2,1,1,1,1,1,1],
[0,0,0,0,0,0,0,0,0,2,2,1,1,1,1,1,1,1,1,1],
[2,2,0,0,0,0,2,2,2,1,1,1,1,1,1,1,1,1,1,1],
[0,0,0,0,2,2,1,1,1,1,1,1,1,1,1,1,1,1,1,1],
[0,0,2,2,1,1,1,1,1,1,1,1,1,1,1,1,1,1,1,1],
[2,2,1,1,1,1,1,1,1,1,1,1,1,1,1,1,1,1,1,1]
],
"h":2048,"w":640,"startx": 0, "starty": 0,"version":1.0,"objects":[
{"type":"flag","x":0, "y":1986},
{"type":"flag","x":128, "y":578},
{"type":"flag","x":544, "y":66}
]}